+-+-+-+-+-+-+-+-+-+-+-+-+-+-+-+-+
|   |   |   |   | | |     |     |
+ + + + + + + + + + + + +-+ +-+ +
| | | |   |   |       |   |   | |
+ + + + + + + + + + +-+ + +-+ + +
| | | | |   |   | | |   |   | | |
+ + + +-+-+-+-+-+-+ + + + + + + +
| | | | |   | |   |   |   | | | |
+ + + + + + + + + +-+-+-+ + + + +
| | | |   |   | | |     |   | | |
+ + + + +-+-+ + + + +-+ +-+ + + +
| | | |     |   |   |       | | |
+ + + + +-+ +-+-+-+-+ +-+-+-+ + +
| | | | |     |     |     |   | |
+ + + +-+ +-+ + +-+ +-+-+ + +-+ +
| | | | |     |   |       |   | |
+ + + + +-+ +-+   + +-+-+-+-+ + +
| | |   |     |   | |   |   | | |
+ + + + + +-+-+ +-+ + + + + + + +
| | | | |   | |       |   |   | |
+ + + + +-+ + +-+-+-+-+-+-+-+-+ +
| |   |   |     |   |   |   |   |
+ + +-+ + +-+ +-+ + + + + + + +-+
| | |   |       | |   |   | |   |
+ + + +-+-+-+-+-+ + +-+-+ + +-+ +
| |   |   |   | |     |     | | |
+ +-+-+ + + + + + +-+-+-+-+ + + +
| | | | | | | |     |   |     | |
+ + + + + + + + + + + + + +-+ + +
|               | |   |   |   | |
+ + + + + + + + + + + + + + + + +
| | | | | | | |     |   |   |   |
+-+-+-+-+-+-+-+-+-+-+-+-+-+-+-+-+
