+-+-+-+-+-+-+-+-+-+-+-+-+-+-+-+-+
|   |     |   |               | |
+-+ + +-+ + + + +-+-+-+-+ +-+ + +
|     |     |   | |       | | | |
+ +-+ +-+ + + +-+ + +-+ +-+ + + +
| |       |                   | |
+ + +-+ +-+ +-+ +-+ +-+ +-+ +-+ +
| |     |   |   |     |   |     |
+ + +-+ + + + +-+ + + + + +-+-+ +
| |     | |   |   | | | |     | |
+ +-+ +-+ +-+-+ +-+-+ + +-+ +-+ +
| |                   |   | |   |
+ + +-+ +-+-+ + +-+-+ +-+ + +-+ +
| |   | | | | |     |   | |     |
+ +-+ + + + + +-+-+ +-+ + +-+-+ +
| | | |     | |   |   |         |
+ + + + +-+ + + + + +-+-+-+ +-+-+
| | |     | | |   | |     |     |
+ + +-+-+ +-+ +-+ + + +-+ + +-+ +
|       | |     |   |   |   | | |
+ +-+-+-+ +-+-+ +-+ + + +-+ + + +
|       |   |       | | |     | |
+ +-+ +-+-+ +-+-+-+ + +-+ +-+-+ +
|   |     | |     | | |   | |   |
+ + +-+-+-+ + +-+ +-+ +-+ + +-+ +
| |     |   | |       |   |   | |
+ + +-+-+-+ + +-+-+ + +-+ + + + +
| | |   |     |     |     | | | |
+ + + + + + +-+ +-+ + + + + + + +
|     |   |     | | | | | | | | |
+ +-+ + +-+ + + + + +-+ + + + +-+
| | | |     | |       |         |
+-+-+-+-+-+-+-+-+-+-+-+-+-+-+-+-+

