+-+-+-+-+-+-+-+-+-+-+-+-+-+-+-+-+
|                               |
+ +-+-+-+-+-+-+-+-+-+-+-+ +-+ +-+
|   |                 |         |
+ + + +-+-+-+-+-+-+-+ +-+-+-+ + +
| | |                       | | |
+ + + +-+-+-+-+-+-+-+-+-+-+ + + +
| | |   | |               | | | |
+ + + + + + +-+-+-+-+-+ + + + + +
| | | | | | |         | | | |   |
+ + + + + + + + +-+-+ + + + + + +
|   |     | | |           |   | |
+ +-+ + + + + + +-+-+ +-+-+ +-+ +
| | | | | | | |       |     | | |
+ + + + + + + +-+-+ + + +-+-+ + +
| | | | | | | |   | | |   | | | |
+ + + + + + + + + + + + + + + + +
| | |       | |   |   | |   | | |
+ + + +-+-+-+ +-+ +-+-+ + + + +-+
| | | |     |         | | |   | |
+ + +-+ +-+ + +-+-+-+ + + +-+ + +
| | | | |   |         |     |   |
+ + + + + + +-+ +-+ +-+-+-+ + + +
| |   |   | |       |         | |
+ + + + +-+ +-+-+ +-+ +-+-+-+-+ +
|   |   |   |     |           | |
+-+-+-+-+ +-+-+ +-+-+-+-+-+ +-+ +
|           |           |       |
+ +-+-+ +-+ +-+-+ +-+-+ +-+-+ + +
| |             |             | |
+ + +-+-+-+-+-+ + +-+-+-+-+-+-+ +
| |             |               |
+-+-+-+-+-+-+-+-+-+-+-+-+-+-+-+-+
