+-+-+-+-+-+-+-+-+-+-+-+-+-+-+-+-+
|                   |           |
+-+-+-+-+-+ +-+-+-+ + +-+ +-+-+ +
|           |     | | | | | | | |
+ +-+-+-+-+-+-+-+-+ +-+-+ + + + +
| |                       | | | |
+ + +-+-+ +-+-+-+-+-+-+-+-+ +-+ +
| | |   | |         |       |   |
+ + + + + + +-+-+-+ + +-+-+ + +-+
| | |   | | |     | | | | | | | |
+ + +-+-+ + +-+-+-+ + + + + + + +
| | |     |         | | | | | | |
+ + +-+-+-+-+-+-+-+-+ + + + + + +
| |                   | | |   | |
+ +-+-+-+-+-+ +-+-+ + + + + +-+ +
|           | |   | | | | | | | |
+-+-+-+ +-+-+ + + + + + + + + + +
| |   | |     |   | | | | | | | |
+ +-+-+ + +-+-+-+ + + + + + + + +
|       | |         | | | | | | |
+ +-+-+-+ +-+-+-+-+-+-+ +-+ +-+ +
| |               |             |
+ + +-+-+-+-+-+-+ + +-+-+-+-+-+ +
| | |           | | |         | |
+ + +-+-+-+-+-+-+ + +-+-+-+-+-+ +
| |                 |           |
+ +-+-+-+-+ +-+-+-+ +-+-+-+-+-+-+
| |       | |     |             |
+ +-+-+-+-+-+-+-+-+-+-+-+-+-+-+ +
|                           | | |
+ +-+-+ +-+-+-+-+-+-+-+-+-+ +-+ +
| |   |           |             |
+-+-+-+-+-+-+-+-+-+-+-+-+-+-+-+-+
