+-+-+-+-+-+-+-+-+-+-+-+-+-+-+-+-+
|           |                   |
+ +-+ +-+-+-+ +-+ +-+ +-+-+-+-+ +
| | |         | | | | |       | |
+ +-+-+-+ +-+-+-+ +-+ +-+-+-+-+ +
|         |                     |
+ +-+-+ +-+ +-+-+-+-+-+-+-+ +-+ +
| |   | | |     | |         | | |
+ + + + + + +-+-+-+-+ +-+-+ + + +
| | | | | | |       | | | | | | |
+ + + + + + + +-+-+ + + +-+ +-+ +
| | | | |   | |   | | |         |
+ + + +-+ + + +-+-+ + + +-+-+-+ +
| | |   | | |       | | |     | |
+ + +-+ + + +-+-+-+-+ + +-+-+ + +
|     | | |       |   |     | | |
+ +-+ + + +-+-+ + +-+-+ +-+ + + +
| | | | |     |         | | | | |
+-+-+ + + +-+ +-+-+-+-+-+ + + + +
|     | | | |             | | | |
+ +-+ + + +-+-+-+-+-+-+-+ + + + +
| | | | |                 | |   |
+ +-+-+ +-+-+-+-+-+-+-+-+ + +-+ +
|     |                 | |   | |
+ +-+ + +-+ +-+-+-+-+-+ + + + + +
| | | | | |             | | | | |
+ + + + +-+-+-+-+-+-+-+ + + + + +
| | | |             | | |   | | |
+ + + + + +-+ +-+ + +-+ +-+-+ + +
| | | | | | | | | |           | |
+ +-+ +-+ +-+ +-+ +-+-+-+-+-+-+ +
| |         |                   |
+-+-+-+-+-+-+-+-+-+-+-+-+-+-+-+-+
