+-+-+-+-+-+-+-+-+-+-+-+-+-+-+-+-+
| |             |       |       |
+ + +-+-+-+-+-+ +-+ + + + + + + +
| |         | |     | | | | | | |
+ +-+ + + + + + +-+ + + +-+ + + +
| | | | | | | |     | |     | | |
+ + + + + + + + +-+-+-+ +-+-+-+ +
| | | | | | | |               | |
+ + + + + + + + +-+-+-+ +-+-+ + +
| |   | | | | |               | |
+ + + + + + + + +-+-+-+ +-+-+ + +
| | | |       |               | |
+ + + + + + + + +-+-+-+ +-+-+ + +
| | | | | | | |               | |
+ +-+ + + + + +-+-+-+-+-+-+-+-+ +
|       | | | |               | |
+ +-+ + + + + + A +-+-+-+-+-+ + +
| | | | | | | |   |             |
+ + + + + + + +-+-+-+-+-+-+-+-+ +
| | | | | | | |               | |
+ + + + + + + + +-+-+-+ +-+-+ + +
| | | |       |               | |
+ + + + + + + + +-+-+-+ +-+-+ + +
| |   | | | | |               | |
+ + + + + + + + +-+-+-+ +-+-+ + +
| | | | | | | |               | |
+ + + + + + + + +-+-+-+ +-+-+-+ +
| | | | | | | |     | |     | | |
+ +-+ + + + + + +-+ + + +-+ + + +
| |         | |     | | | | | | |
+ + +-+-+-+-+-+ +-+ + + + + + + +
|||             |       |       |
+-+-+-+-+-+-+-+-+-+-+-+-+-+-+-+-+
