+-+-+-+-+-+-+-+-+-+-+-+-+-+-+-+-+
| |                             |
+ + +-+-+-+-+-+-+-+ +-+-+ +-+-+ +
| | |                         | |
+ + +-+-+-+-+-+ +-+-+-+ +-+-+ + +
|   |                 |     | | |
+ +-+ +-+-+-+-+-+-+-+ +-+-+ + + +
|   | |     |             | | | |
+ + + + +-+-+-+-+-+-+-+-+-+ + + +
| | | | |       |       | | | | |
+ + + + + +-+-+-+-+-+-+ + + + + +
| | | | | |     |     | | | |   |
+ + + + + + +-+-+-+-+ + + + + + +
| | | | | | |       | |   | | | |
+ + + + + + + +-+-+ + + + + + + +
| | | | | | | |   | | | | | | | |
+ + + + + + + + + + + + + + + + +
| | |       |     | |   | | | | |
+ + + + + + +-+-+-+ + + + + + + +
| | | | | | |       | | | |   | |
+ + + + + + +-+-+ +-+ + + + + + +
| | | | | | |         | | | | | |
+ + + + +-+-+-+-+-+-+-+ + + + + +
| | | | |               | | |   |
+ + + + +-+-+-+-+ +-+-+-+ + + + +
|   | |                   | | | |
+ +-+ +-+-+-+-+-+-+-+-+-+-+ + + +
|   |                     | | | |
+ + +-+-+-+-+-+-+ +-+-+-+-+-+ + +
| | |           |               |
+ + +-+-+ +-+-+-+-+-+-+-+-+-+-+ +
| |                             |
+-+-+-+-+-+-+-+-+-+-+-+-+-+-+-+-+
