+-+-+-+-+-+-+-+-+-+-+-+-+-+-+-+-+
| |           |                 |
+ + +-+ +-+ +-+ +-+-+-+-+-+ + + +
| |   |       |           | | | |
+ + + + +-+ +-+-+-+-+-+-+ + + + +
| | | |                   |   | |
+ + + +-+-+-+-+-+-+-+-+-+-+ +-+ +
|   | |                   | |   |
+ + + + +-+ +-+ +-+-+-+-+ + + +-+
| | | |           |       | | | |
+ + + + +-+ +-+ +-+ + + +-+ + + +
| | | |           | | | | | |   |
+ + + + +-+ +-+-+-+ + + + + +-+ +
|   | |     |     | | | | | | | |
+ + + +-+-+ + +-+ + + + + + + + +
| | |   |     |   |       | |   |
+ + + +-+-+ + + + + + + + + + + +
| | |     | | |   | | | | | | | |
+ + +-+ +-+-+ +-+-+ + + + + + + +
|   |       | |     | | | | | | |
+ + + +-+ +-+-+ +-+ + + + + + + +
| | |       | |           | |   |
+ + + + +-+ + +-+-+-+-+-+ + + + +
| | | |   |   |   |   | | | | | |
+ + +-+-+ + + + + + + + + + + + +
| |     |   |   |   |     | | | |
+ +-+-+ +-+ + + + + + + +-+ + + +
|     | |     |   |   |     |   |
+ +-+ + +-+-+-+-+-+-+-+-+-+-+-+ +
| | | |                         |
+ + + +-+-+-+ +-+-+ +-+-+-+-+ + +
| |                           | |
+-+-+-+-+-+-+-+-+-+-+-+-+-+-+-+-+
