+-+-+-+-+-+-+-+-+-+-+-+-+-+-+-+-+
|               |       |       |
+ + +-+ +-+-+-+ + +-+-+ + + +-+ +
| | | | |       |     |   | |   |
+ + + + +-+-+-+ + + + + + + +-+ +
| | | |         | | | | | |     |
+ + + + +-+-+-+ + + + + + +-+-+-+
| | | | |       |   | | |       |
+ +-+ + +-+-+-+ +-+-+ + +-+-+-+ +
|             |       |         |
+ +-+-+-+-+-+-+-+-+-+-+-+-+-+-+ +
| |       |           |       | |
+ +-+-+-+ + +-+ +-+-+ + +-+-+ + +
|       | | |       | | |   | | |
+ + +-+ + + + + +-+ + + + +-+ + +
| | | | | | | |   | | | |     | |
+ + + + + + + + + + + + +-+-+-+ +
| | | | | | | |   | | |         |
+ +-+ +-+ + + +-+-+ + +-+-+-+-+ +
|         |               |   | |
+-+-+-+ +-+-+-+-+-+-+-+-+ + + + +
|           |             | | | |
+ +-+-+ +-+-+-+-+ +-+-+ +-+ + + +
| |             | |             |
+ + +-+ + +-+ + + +-+-+-+-+-+ + +
| | | | | | | | |           | | |
+ + + + + + + + + +-+-+-+-+-+ + +
| | | | | | | | |             | |
+ + + + + + + + + +-+-+-+-+-+ + +
| | | | | | | | | |           | |
+ + + +-+ + +-+ + +-+-+-+-+-+-+ +
| |             |               |
+-+-+-+-+-+-+-+-+-+-+-+-+-+-+-+-+
