+-+-+-+-+-+-+-+-+-+-+-+-+-+-+-+-+
|                               |
+ +-+-+-+-+-+-+-+-+-+-+-+-+-+-+ +
| |                           | |
+ + +-+-+-+-+ + +-+-+-+-+-+-+ + +
| | |       | |             | | |
+ + + +-+-+ + + +-+-+ +-+-+ + + +
| | | |   | | | |         | |   |
+ + + + + + + + +-+-+-+-+ + + +-+
| | | | | | | |           | | | |
+ + + + + + + +-+-+-+-+ +-+ + + +
| | | | | | | |       |     | | |
+ + + + + + + + +-+-+ +-+-+ + + +
| | | | | | |   |         |   | |
+ + + + + + + +-+ + +-+-+ +-+-+ +
| | | | | | | |   | |   | |     |
+ + + + + + + + + + + + + +-+ +-+
| |     | | | |   | | | |   |   |
+ +-+-+-+ + + +-+-+ + + +-+ +-+ +
| |     | | |       |     | |   |
+ + + +-+ + +-+-+-+-+-+-+ + + +-+
| | |     | |             | |   |
+ + +-+-+-+ + +-+-+ +-+ +-+ +-+ +
| |   |     |                   |
+ + + + +-+-+-+-+-+-+ +-+ +-+ +-+
|   |   |           |           |
+-+ + +-+ +-+-+-+-+ +-+ +-+ +-+ +
|   | |   |       |   |         |
+ + + + +-+ +-+-+ +-+ +-+ +-+ +-+
| | |   |     |     |   |       |
+ + + +-+-+-+ + +-+-+-+ +-+-+-+ +
| |           |                 |
+-+-+-+-+-+-+-+-+-+-+-+-+-+-+-+-+
