+-+-+-+-+-+-+-+-+-+-+-+-+-+-+-+-+
|                       |       |
+ +-+-+-+-+-+-+ +-+ + + + + + + +
| |         | | |   | | | | | | |
+ +-+ + + + + + +-+ + + +-+ + + +
| | | | | | | | |   | |     | | |
+ + + + + + + + +-+-+-+ +-+-+-+ +
| | | | | | | |               | |
+ + + + + + + + +-+-+-+ +-+-+ + +
| |   | | | | | |             | |
+ + + + + + + + +-+-+-+ +-+-+ + +
| | | |       | |             | |
+ + + + + + + + + +-+-+ +-+-+ + +
| | | | | | | | |             | |
+ +-+ + + + + +-+-+-+-+-+-+-+-+ +
|       | | | |   |           | |
+ +-+ + + + + + A +-+-+-+-+-+ + +
| | | | | | | |   |             |
+ + + + + + + + +-+-+-+-+-+-+-+ +
| | | | | | | | |             | |
+ + + + + + + + +-+-+-+ +-+-+ + +
| | | |       | |             | |
+ + + + + + + + +-+-+-+ +-+-+ + +
| |   | | | | | |               |
+ + + + + + + + +-+-+-+ +-+-+ + +
| | | | | | |   |             | |
+ + + + + + + + + +-+-+ +-+-+-+ +
| | | | | | | |     | |     | | |
+ +-+ + + + + + + +-+ + +-+ + + +
| |         | | |   | | | | | | |
+ + +-+-+-+-+-+-+-+-+ +-+ + + + +
|||                             |
+-+-+-+-+-+-+-+-+-+-+-+-+-+-+-+-+
