+-+-+-+-+-+-+-+-+-+-+-+-+-+-+-+-+
|                               |
+ +-+-+-+-+-+-+ +-+-+-+-+-+-+-+ +
| |                           | |
+ + +-+-+-+-+-+-+-+-+-+-+-+ + + +
| | |                       | | |
+ + + +-+-+-+-+-+-+-+ +-+-+ + + +
| | | |                   | | | |
+ + + + +-+-+-+-+-+-+-+-+ + + + +
| | | | |               | | | | |
+ + + + + +-+-+-+-+-+-+ + + + + +
| | | | | |           | | | | | |
+ + + + + + +-+-+ +-+ + + + + + +
| | | | | | |       | | | | | | |
+ + + + + + + +-+-+ + + + + + + +
|   | | | | | |   | | | | |     |
+ + + + + + + + + + + + + + + + +
| | | |   | | |   | | | | | | | |
+ + + + + + + + +-+ + + + + + + +
| | | | | | | |     |   | | | | |
+ + + + + + + +-+-+-+ + + + + + +
| | | | | | |         | | | | | |
+ + + + + + +-+-+-+-+-+ + + + + +
| | | | | |             | | | | |
+ + + + + +-+-+-+ +-+-+-+ + + + +
| | | | |                 | | | |
+ + + + +-+-+-+-+-+-+-+-+-+ + + +
| | | |                     | | |
+ + + +-+-+-+-+-+-+-+-+-+-+-+ + +
|   |                         | |
+ + +-+-+-+-+-+-+ +-+-+-+-+-+-+ +
| |                             |
+-+-+-+-+-+-+-+-+-+-+-+-+-+-+-+-+
