+-+-+-+-+-+-+-+-+-+-+-+-+-+-+-+-+
|                       |       |
+ +-+-+-+-+-+-+ +-+ + + + + + + +
| |         | | |   | | | | | | |
+ +-+ + + + + + +-+ + + +-+ + + +
| | | | | | | | |   | |     | | |
+ + + + + + + + +-+-+-+ +-+-+-+ +
| | | | | | | |               | |
+ + + + + + + + +-+-+-+ +-+-+ + +
| |   | | | | | |             | |
+ + + + + + + + +-+-+-+ +-+-+ + +
| | | |       | |             | |
+ + + + + + + + + +-+-+ +-+-+ + +
| | | | | | | | |             | |
+ +-+ + + + + +-+-+-+-+-+-+-+-+ +
|       | | | |   |           | |
+ +-+ + + + + + + +-+-+-+-+-+ + +
| | | | | | | |   |             |
+ + + + + + + + +-+-+-+-+-+-+-+ +
| | | | | | | |               | |
+ + + + + + + + +-+-+-+ +-+-+ + +
| | | |       | |             | |
+ + + + + + + + +-+-+-+ +-+-+ + +
| |   | | | | | |               |
+ + + + + + + + +-+-+-+ +-+-+ + +
| | | | | | |   |             | |
+ + + + + + + + + +-+-+ +-+-+-+ +
| | | | | | | |     | |     | | |
+ +-+ + + + + + + +-+ + +-+ + + +
| |           | |   | | | | | | |
+ + +-+-+-+-+-+-+-+-+ +-+ + + + +
| |                             |
+-+-+-+-+-+-+-+-+-+-+-+-+-+-+-+-+
