+-+-+-+-+-+-+-+-+-+-+-+-+-+-+-+-+
|               |       |       |
+ +-+-+-+-+-+-+ +-+ + + + + + + +
| |         | |     | | | | | | |
+ +-+ + + + + + +-+ + + +-+ + + +
| | | | | | | |     | |     | | |
+ + + + + + + + +-+-+-+ +-+-+-+ +
| | | | | | | |               | |
+ + + + + + + + +-+-+-+ +-+-+ + +
| |   | | | | |               | |
+ + + + + + + + +-+-+-+ +-+-+ + +
| | | |       |               | |
+ + + + + + + + +-+-+-+ +-+-+ + +
| | | | | | | |               | |
+ +-+ + + + + +-+-+-+-+-+-+-+-+ +
|       | | | |   |           | |
+ +-+ + + + + + + +-+-+-+-+-+ + +
| | | | | | | |   |             |
+ + + + + + + + +-+-+-+-+-+-+-+ +
| | | | | | | | |             | |
+ + + + + + + + +-+-+-+ +-+-+ + +
| | | |       | |             | |
+ + + + + + + + +-+-+-+ +-+-+ + +
| |   | | | | | |               |
+ + + + + + + + +-+-+-+ +-+-+ + +
| | | | | | | | |             | |
+ + + + + + + + +-+ + + +-+-+-+ +
| | | | | | | |     | |     | | |
+ +-+-+ + + + + +-+ + + +-+ + + +
| |         | | |   | |   | | | |
+ + +-+-+-+-+-+-+-+-+-+-+ + + + +
| |                             |
+-+-+-+-+-+-+-+-+-+-+-+-+-+-+-+-+
