+-+-+-+-+-+-+-+-+-+-+-+-+-+-+-+-+
|               |               |
+ +-+-+-+-+-+-+ + +-+-+-+ + +-+ +
| |                       |   | |
+ + + +-+-+-+-+-+-+-+-+-+ +-+ +-+
| | |                   |   |   |
+ + + +-+-+-+-+-+-+-+-+ +-+ +-+ +
| | | |               |   |   | |
+ + + + +-+-+-+-+-+-+ +-+ +-+ + +
| | | | |                       |
+ + + + + +-+-+-+-+ +-+ +-+-+-+ +
| | | |   |       |   |   |     |
+ + + + + + +-+-+ + + +-+ + + + +
| | | | |   |   |   |   |   | | |
+ + + + + + + + +-+ +-+ + + + + +
|   | | | | | |   |   | | | |   |
+-+ + + + + + + + + + + + + + +-+
|   | | | |   |   | | | | | |   |
+ + + + + +-+ +-+-+ + + + + + + +
| | |   |   |       | | | | | | |
+ + + + +-+ +-+ +-+-+ + + + + + +
| | | |   |   |       | | | | | |
+ + + +-+ + + +-+-+ +-+ + + + + +
| | |   |   |           | | | | |
+ + +-+ +-+ +-+-+-+-+ +-+ + + + +
| |   |   |               | | | |
+ +-+ +-+ + +-+-+-+-+-+ +-+ + + +
|   |   | |                 | | |
+-+ +-+ + +-+-+-+-+-+-+-+ +-+ + +
|   | |                 |     | |
+ + + +-+-+-+-+ + +-+-+-+-+ +-+ +
| |             |               |
+-+-+-+-+-+-+-+-+-+-+-+-+-+-+-+-+
