+-+-+-+-+-+-+-+-+-+-+-+-+-+-+-+-+
|                               |
+ +-+-+-+-+ +-+-+-+-+ +-+-+-+-+ +
| |                           | |
+ + +-+-+-+-+-+-+-+-+-+-+-+-+ + +
| | |                       | | |
+ + + +-+ +-+-+-+-+-+-+ +-+ + + +
| | | |   |           |   | | | |
+ + + + +-+ +-+-+-+-+ +-+ + + + +
| | |   |   |       |   |   | | |
+ + + +-+ +-+ +-+-+ +-+ +-+ + + +
|   | |   |   |   |   |   | |   |
+ + + + +-+ +-+ + +-+ +-+ + + + +
| | | | |       |   |   | |   | |
+ + + + + +-+ +-+-+ +-+ + + + + +
| | |   | |   |       |   | | | |
+ + + +-+ + +-+ + +-+ +-+ + + + +
| | |   | |   |   |   |   | | | |
+ + + + + + + +-+-+ +-+ + + + + +
| | | | |   |   |   |   | | |   |
+ + + + +-+ +-+ + +-+ +-+ + + + +
|   | |   |   |   |   |   | | | |
+ + + +-+ +-+ +-+-+ +-+ +-+ + + +
| | |   |   |       |   |   | | |
+ + + + +-+ +-+-+-+-+ +-+ + + + +
| | | |   |           |   | | | |
+ + + +-+ +-+-+-+-+-+-+ +-+ + + +
| | | | |                   | | |
+ + + +-+-+-+-+-+-+-+-+-+-+-+ + +
| | |                         | |
+ + +-+-+-+-+-+-+-+-+-+-+-+-+-+ +
| |                             |
+-+-+-+-+-+-+-+-+-+-+-+-+-+-+-+-+
