+-+-+-+-+-+-+-+-+-+-+-+-+-+-+-+-+
| |                             |
+ + + +-+-+-+-+-+-+-+-+-+-+-+-+ +
| | | | |   |                 | |
+ + + + + + +-+-+-+-+-+-+-+ + + +
| | | | | |           | | | | | |
+ + + + + + +-+-+-+-+ + + + + + +
| | | | | | |         | | | | | |
+ + + + + + + +-+-+-+-+ + + + + +
|   | | | | |         | | | | | |
+ + + + + + + +-+ +-+ + + + + + +
| | | | | | | |   | | | | | | | |
+ + + + + + + +-+-+ + + + + + + +
| | | |   | |       | | | | | | |
+ + + + + + + +-+-+ + + + + + + +
| | | | | | | |     | |         |
+ + + + + + + + + + + +-+ + +-+ +
|   | | | | | |   | | |   |   | |
+ + + + + + + +-+-+-+ +-+ + +-+ +
| | |   | | |         | | | | | |
+ + + + + + + +-+-+-+ + + + + + +
| | | | | | |             |   | |
+ + + + + + +-+-+-+-+-+-+-+-+ + +
| | | | | |                 | | |
+ + + +-+ +-+-+-+-+-+ +-+-+ + + +
|   |                       | | |
+ + + +-+-+-+-+-+ +-+-+-+-+-+ + +
| | |                         | |
+ + + +-+-+-+-+-+-+-+-+-+-+-+ + +
| | |                         | |
+ + +-+-+-+-+-+-+ +-+-+-+-+-+-+-+
| |                             |
+-+-+-+-+-+-+-+-+-+-+-+-+-+-+-+-+
