+-+-+-+-+-+-+-+-+-+-+-+-+-+-+-+-+
|       |   | |   |     |       |
+-+-+ + + + + + + + + + + +-+-+ +
|     |   |   | | | | |     |   |
+ +-+ + +-+-+ + + + + + + + + + +
|   | |     | | | | | | | | | | |
+ + + + + + + + + + + + + + + + +
| | | | | |     |     | | |   | |
+ +-+ +-+-+-+ +-+-+-+-+ + +-+ + +
|   |   |   | |         |   |   |
+ + +-+-+-+ +-+ + + + +-+-+ +-+-+
| | |       | | | | |     |     |
+-+ + +-+ +-+ + + + + +-+-+-+-+ +
|   |         |   | |     |     |
+ +-+-+-+-+-+-+-+-+-+-+-+ + +-+ +
|           | |   |       |   | |
+ +-+-+-+-+-+ + + + +-+-+ +-+ +-+
| |         | |   |         |   |
+ + +-+-+-+ + + +-+-+-+ + + + +-+
| | |       | | |   | | | | | | |
+ + +-+-+-+ + + + + + + +-+-+ + +
| |       |   |   |   |     | | |
+ + +-+ +-+-+-+ +-+ + + +-+ + + +
| | |               |   |   | | |
+ +-+-+-+-+-+-+-+-+-+-+-+-+ + + +
| |       |     | |       | |   |
+ +-+-+ + + +-+ + + +-+-+ +-+-+ +
|     | |   | |   |         | | |
+ +-+ + +-+-+ + +-+-+-+-+-+ + + +
| | | |   |       |         |   |
+ + + + + + +-+-+ +-+-+ + +-+-+ +
| |     |       |       |       |
+-+-+-+-+-+-+-+-+-+-+-+-+-+-+-+-+
