+-+-+-+-+-+-+-+-+-+-+-+-+-+-+-+-+
|                               |
+ +-+-+-+-+-+-+-+-+-+-+-+-+-+ + +
| |                         | | |
+ + +-+-+-+-+-+-+-+-+ +-+-+ + + +
| | |               | |   | | | |
+ + + +-+-+-+-+-+-+ + + + + + + +
| |   |             | | | | | | |
+ +-+-+ +-+-+-+-+-+-+ + + + + + +
| | |   |   |       | | | | | | |
+ + + +-+ + + +-+-+ + + + + + + +
| |   |   | | |     | | | | | | |
+ + +-+ +-+ + + +-+ + + + + + + +
| |     |   | |   |   | | | | | |
+ +-+-+-+ +-+ +-+-+ +-+ + + + + +
|       |   |     | | | | | | | |
+ +-+-+ +-+ + + + + + + + + + + +
| |   |     | |   | |   | | | | |
+ + + +-+-+-+ +-+-+ + +-+ + + + +
| | |       |   |   |   | | | | |
+ + +-+-+ +-+-+ + +-+-+ + + + + +
| |     |   |   |     | | | | | |
+ +-+-+ +-+ + +-+-+-+ + + + + + +
| |   |   | |       | | | | | | |
+ + + +-+ + +-+-+ + + + + + + + +
|   | |   |       |   | | | | | |
+-+ + + +-+-+-+-+-+-+-+ + + +-+ +
|   | |                 | |     |
+ + + +-+-+-+-+-+-+-+-+-+ +-+-+-+
| | |                           |
+ + +-+-+-+-+-+-+-+-+-+-+-+-+-+ +
| |                             |
+-+-+-+-+-+-+-+-+-+-+-+-+-+-+-+-+
