+-+-+-+-+-+-+-+-+-+-+-+-+-+-+-+-+
|                 | | | |       |
+ +-+ +-+ +-+ +-+ + + + + +-+-+ +
| |           |   |   | | |   | |
+ +-+-+-+-+-+ + + + + + + + + + +
| |           | | | | | | | | | |
+ + +-+-+ +-+ + + + + + + +-+ + +
| |     |     | |   |   |     | |
+ +-+ +-+-+-+-+-+-+-+ + +-+-+-+ +
|   |               | |         |
+-+ +-+-+-+-+-+-+-+ +-+-+ +-+-+-+
|       |             |         |
+-+-+ +-+ +-+-+-+-+-+ +-+-+-+ +-+
|       | | |       |   |       |
+ +-+-+-+ + + +-+ + + + + +-+-+-+
|       | | | |   | | | |       |
+-+-+-+ + + + + + + + + +-+-+ + +
|       |   | |   | | | |     | |
+ +-+-+-+-+ + +-+-+ + + + +-+-+ +
|         |         | | |       |
+-+-+-+ +-+-+ +-+-+-+ + + + + + +
|           |       | | | | | | |
+ +-+-+ +-+ +-+ +-+-+ + + + + +-+
|     | | | | |       | |   |   |
+ +-+ + + + + +-+-+-+-+ +-+ + + +
|   | | | |   |   | | | | | | | |
+-+-+ +-+ + + + + + + + + + + + +
|         | | | | |   |   | |   |
+ +-+-+ +-+ + + + + + +-+ + + + +
| |   | |   | | | | |   |   | | |
+ + +-+ +-+ + + + + + + +-+-+-+ +
| |         |   |   | |         |
+-+-+-+-+-+-+-+-+-+-+-+-+-+-+-+-+
