+-+-+-+-+-+-+-+-+-+-+-+-+-+-+-+-+
|   |   | |               |     |
+ + + + + + +-+-+-+-+-+-+ +-+ + +
| | | |     | |   |   |   |   | |
+ + + + +-+-+ + + +-+ + +-+ +-+ +
|   | | |     | |   | |   |   | |
+ + + + +-+ + + + + + + +-+-+ + +
| |   | | | |   | |   |       | |
+ +-+-+ + + +-+-+-+-+ +-+-+-+-+ +
| |   | |       |   |         | |
+ + + + +-+ + + + +-+-+ +-+-+ + +
| | | |     | | | |         |   |
+ + + +-+ +-+ + + + +-+-+-+ + + +
| | |   |   | |   |     |   | | |
+ + + + +-+ +-+-+-+-+-+ + +-+ + +
|   | |   |   |   |   | | |   | |
+ + + +-+ +-+ + + + + +-+ +-+-+-+
| | | | |   | |     |           |
+ + + + +-+ + +-+-+-+-+-+-+-+-+ +
|   | |   | |   |               |
+ + + + + + +-+ + +-+-+-+-+-+-+-+
| | | | | |     |               |
+ + + + + + +-+-+-+-+-+ +-+-+-+-+
|   | | | |     |       |       |
+ + + + + + +-+-+-+-+-+ + + + + +
| | | | | |   |           | | | |
+-+-+ + + +-+ +-+-+-+-+-+-+-+ + +
|       | | |     | | | | |   | |
+ +-+ + + + +-+ +-+ + + + + +-+ +
| | | | | |   |                 |
+ + + + +-+ + +-+-+ + + + + + + +
| |   |   | |       | | | | | | |
+-+-+-+-+-+-+-+-+-+-+-+-+-+-+-+-+
