+-+-+-+-+-+-+-+-+-+-+-+-+-+-+-+-+
|         |             |       |
+ +-+-+-+ + +-+-+-+-+ + + +-+-+ +
|       | |     |     |   |   | |
+-+ +-+ + +-+ +-+ +-+ + + + + + +
|   |   |             | | | | | |
+ + + + + +-+ +-+ +-+ + + + + + +
| | | |                 | | | | |
+ + + + + +-+ +-+ +-+ + + + + + +
| | | | |             | | | | | |
+ + +-+ +-+-+ +-+ +-+ + + + + + +
| |     |       | |   | | | | | |
+ +-+-+ +-+ +-+-+-+-+-+-+ + + + +
| |   | | | |             | | | |
+ + + + + + + + +-+-+ + +-+ + + +
| | |   | | | |   | | | |   | | |
+ + +-+-+ + + + + + + + + + + + +
| | |     | | |   | | | | | | | |
+ + + + +-+ + +-+-+ + + + + + + +
| | | |     |       | | | | | | |
+ + + +-+ +-+-+-+-+ + + + + + + +
| | |   |   |     | | | | | | | |
+ + +-+ +-+ + +-+ + + + + + + + +
| |   |   |   |   | | | | | | | |
+ + + +-+ +-+ +-+ + + +-+ + + + +
|   |   |   |     | | |   | | | |
+-+ + + +-+ + +-+-+ + +-+-+ + + +
|   | |     |       |       | | |
+ + + +-+-+-+-+-+-+-+-+-+-+-+ + +
| | |             |           | |
+ + +-+-+-+-+-+-+ + + +-+-+-+-+ +
| |                 |           |
+-+-+-+-+-+-+-+-+-+-+-+-+-+-+-+-+
