+-+-+-+-+-+-+-+-+-+-+-+-+-+-+-+-+
|       |   | |   |     |       |
+-+-+ + + + + + + + + + + +-+-+ +
|     |   |   | | | | |     |   |
+ +-+ + +-+-+ + + + + + + + + + +
|   | |     | | | | | | | | | | |
+ + + + + + + + + + + + + + + + +
| | | | | |     |     | | |   | |
+ +-+ +-+-+-+ +-+-+-+-+ + +-+ + +
|   |   | |   |         |   |   |
+ + +-+ + + +-+ + + + +-+-+ +-+-+
| | |   |   | | | | |     |     |
+-+ + +-+ +-+ + + + + +-+-+-+-+ +
|   |         |   | |     |     |
+ +-+-+-+-+-+-+-+-+-+-+-+ + +-+ +
|           |     |       |   | |
+ +-+-+-+-+-+ + + + +-+-+ +-+ +-+
| |         | |   |         |   |
+ + +-+-+-+ + +-+-+-+-+ + + + +-+
| | |       | | |   | | | | | | |
+ + +-+-+-+ + + + + + + +-+-+ + +
| |       |   |   |   |     | | |
+ + +-+ +-+-+-+ +-+ + + +-+ + + +
| | |               |   |   | | |
+ +-+-+-+-+-+-+-+-+-+-+-+-+ + + +
| |       |     | |       | |   |
+ +-+-+ + + +-+ + + +-+-+ +-+-+ +
|     | |   | |   |         | | |
+ +-+ + +-+-+ + +-+-+-+-+-+ + + +
| | | |   |       |         |   |
+ + + + + + +-+-+ +-+-+ + +-+-+ +
| |     |       |       |       |
+-+-+-+-+-+-+-+-+-+-+-+-+-+-+-+-+
