+-+-+-+-+-+-+-+-+-+-+-+-+-+-+-+-+
|                 |             |
+-+ + +-+ +-+ +-+ + +-+-+ + +-+ +
|   |           |     |   |   | |
+ +-+-+-+ +-+-+-+ +-+ + +-+-+ + +
| |                             |
+ +-+-+-+-+-+-+-+-+-+-+-+-+-+-+ +
|                               |
+ +-+-+-+-+-+-+-+-+-+-+-+-+-+-+ +
| |                             |
+ +-+-+-+-+-+-+-+-+-+-+-+-+-+ + +
|             |   |   |   |   | |
+ +-+-+-+ +-+-+ + + + + + + +-+ +
| |           | |   |   |   |   |
+ +-+-+-+-+-+-+ +-+-+-+-+-+-+ +-+
|             |   |       |   | |
+ +-+-+-+-+-+ + + +-+-+-+ + +-+ +
| |   |       |   |       |   | |
+-+ + + +-+ + +-+-+ +-+-+-+ + + +
| | |       |         |     | | |
+ +-+ +-+ + + +-+-+ +-+-+ +-+ + +
| |       |       |     |   |   |
+ + +-+ + + +-+-+ +-+ +-+-+ +-+ +
|       |       | |   |   |   | |
+ +-+ + + +-+ +-+ + +-+ + +-+ + +
|     |       | | |   | |   |   |
+-+ + + + +-+-+ + +-+ + +-+ + + +
|   |   | |       |   | | | | | |
+ + + +-+ +-+ +-+-+ +-+ + + +-+ +
| |   |   |   |   |     |     | |
+ +-+-+ +-+ + + + +-+ +-+ +-+ + +
| |         |   |               |
+-+-+-+-+-+-+-+-+-+-+-+-+-+-+-+-+
