+-+-+-+-+-+-+-+-+-+-+-+-+-+-+-+-+
|                             | |
+ +-+-+-+-+-+-+-+-+-+ + + + + + +
| |                 | | | | |   |
+ + +-+-+-+-+-+-+-+ + +-+-+-+ +-+
| |             | | | |     |   |
+ +-+-+-+ +-+-+-+ + + + +-+ +-+ +
|               |   | |       | |
+ +-+-+-+-+-+-+ + + + + + +-+ + +
|             | | |   |   | | | |
+-+-+-+-+-+-+ + + + +-+-+-+ +-+ +
|             | | |             |
+-+ +-+-+-+-+-+-+ +-+ +-+-+-+-+ +
|           |   |             | |
+-+-+ +-+-+-+ +-+ + +-+-+-+-+ + +
|     |     | |   |         | | |
+-+ +-+ +-+ + + + +-+-+-+-+-+ + +
|   |   |   | |   | |       | | |
+ +-+ +-+ +-+ +-+-+ +-+-+ + + + +
| |   |   |         |   | |   | |
+ + +-+ +-+ + +-+-+-+ + + + + + +
|   |   | | | |   | | | | | | | |
+ +-+ +-+ + +-+ + + + + + + + + +
| |   |     |   | | | | | | | | |
+-+ +-+ +-+-+ +-+ + + + + + + + +
|         |   |   | | | | | | | |
+-+-+ + +-+ +-+ +-+ + + + + + + +
|     | |   |   |   | | | | | | |
+ + + + + +-+ +-+ + + + + + + + +
| | | |   |   |   |   | | |   | |
+ +-+ + +-+ +-+ + + + + + +-+-+ +
| |   | |       | | | |         |
+-+-+-+-+-+-+-+-+-+-+-+-+-+-+-+-+
