+-+-+-+-+-+-+-+-+-+-+-+-+-+-+-+-+
|                               |
+ +-+-+ +-+-+ + +-+-+-+ + + +-+ +
|             | |     | | | | | |
+ +-+-+-+-+-+ +-+ +-+ + + + + + +
|           |     | | | | | | | |
+ +-+ +-+ + + +-+ +-+ + + + +-+ +
| | | | | | | | |     | |       |
+ + + + + + + + +-+-+-+ +-+-+-+ +
| | | | | | | |                 |
+-+ +-+ +-+ +-+ +-+ +-+ +-+-+-+ +
|           |   |     | |     | |
+ +-+ +-+ +-+-+ +-+-+-+ + +-+ + +
| | | | | | |         | | | | | |
+ + + + + + + +-+ + + + + +-+ + +
| | | | | | | |   | |   |     | |
+ + +-+ +-+ + + + + +-+ +-+ +-+ +
|           | |   | |     |     |
+-+-+ +-+-+-+ +-+-+ + +-+-+ +-+ +
|           |       | |         |
+ +-+-+-+-+ +-+-+-+-+-+-+-+-+ + +
| |         | |     |       | | |
+ + +-+-+ + + + +-+-+ +-+-+ + + +
| |     | |   | |     |     | | |
+-+-+-+ + + + + +-+-+ +-+-+ + + +
|       |   | |     |     | |   |
+ +-+-+ + + +-+ +-+-+ +-+-+ + + +
| |     | |     |     |     | | |
+ + +-+-+ + +-+ +-+-+ +-+-+ + + +
| |       | | |     |     | | | |
+ +-+-+ +-+ + + +-+-+ +-+-+ + + +
| |         |         |         |
+-+-+-+-+-+-+-+-+-+-+-+-+-+-+-+-+
