+-+-+-+-+-+-+-+-+-+-+-+-+-+-+-+-+
|   |   |   |                   |
+ + + + + +-+ + + +-+-+-+-+-+-+ +
| |   |       | |             | |
+ + +-+ +-+ + +-+ +-+-+-+-+-+ + +
|       |   |     |           | |
+ +-+ + + + +-+-+-+ +-+-+-+-+-+ +
| |   |   |                   | |
+ + + + + +-+ +-+-+-+-+-+-+-+ + +
|   |   |   |                 | |
+ + + + +-+-+ +-+-+-+-+-+-+-+-+ +
| |   |       |                 |
+ + + +-+ +-+-+ +-+-+-+-+-+-+-+ +
|   |   |     | |   |   |   |   |
+ +-+-+-+-+ + + +-+ + + + + + + +
|           | |   | | |   |   | |
+ +-+-+-+-+-+ + + + + +-+-+-+ + +
| |         | |   | |       | | |
+ + +-+-+-+ +-+-+-+ +-+-+-+ + + +
| | |       |               | | |
+ + + +-+-+-+ +-+-+-+-+ +-+-+ + +
|   | |               |       | |
+-+ + + +-+-+-+-+-+-+ +-+-+-+-+ +
|   | | |                     | |
+ + + + + +-+-+-+-+-+-+-+-+-+ + +
| | | | |             |         |
+ + + + +-+-+-+-+-+-+ + +-+-+-+ +
| | | |             | |       | |
+ + + + +-+-+-+-+-+ + +-+-+-+ + +
| | |   |           | |       | |
+ + +-+-+ + +-+-+-+-+ + +-+-+-+-+
| |       |                     |
+-+-+-+-+-+-+-+-+-+-+-+-+-+-+-+-+
