+-+-+-+-+-+-+-+-+-+-+-+-+-+-+-+-+
|           |                   |
+ +-+ + +-+-+ + + +-+-+-+-+-+-+ +
| |   |       | |             | |
+ + +-+ +-+ + +-+ +-+-+-+-+-+ + +
| |   | |   |     |           | |
+ +-+ + + + +-+-+-+ +-+-+-+-+-+ +
| |   |   | |                 | |
+ + +-+-+ +-+ +-+-+-+-+-+-+-+ + +
| | |   |   |                 | |
+ + + + +-+-+ +-+-+-+-+-+-+-+-+ +
| |   |       |                 |
+ + + +-+ +-+-+ +-+-+ +-+-+-+-+-+
|   |   |     | |   |   |   |   |
+-+ +-+-+-+ + + +-+ + + + + + + +
|           | |   | | |   |   | |
+ +-+-+-+-+-+ + + + + +-+-+-+ + +
| |         | |   | |       | | |
+ + +-+-+-+ +-+-+-+ +-+-+-+ + + +
| | |       |               | | |
+ + + +-+-+-+ +-+-+-+-+ +-+-+ + +
|   | |               |       | |
+-+ + + +-+-+-+-+-+-+ +-+-+-+ + +
|   | | |                     | |
+ + + + + +-+-+-+-+-+-+-+-+-+ + +
| | | | |             |         |
+ + + + +-+-+-+-+-+-+ + +-+-+-+ +
| | | |             | |       | |
+ + + + +-+-+-+-+-+ + +-+-+-+ + +
| | |   |           | |       | |
+ + +-+-+ + +-+-+-+-+ + +-+-+-+ +
| |       |                     |
+-+-+-+-+-+-+-+-+-+-+-+-+-+-+-+-+
