+-+-+-+-+-+-+-+-+-+-+-+-+-+-+-+-+
|                           |   |
+ +-+-+-+-+ +-+-+-+-+-+-+-+-+ + +
| |                           | |
+ + +-+-+-+-+-+-+-+-+-+-+-+-+ + +
| | | |       |     |       | | |
+ + + +-+ + + + + + + +-+ + + + +
| | |     | | | | |   | | | | | |
+ + +-+ + + + + + +-+-+ +-+ + + +
|   |   | | |   | |   | |   | | |
+ + + +-+-+-+-+-+ + + + + + + + +
| | |           | | | | | | | | |
+ + +-+-+-+ + +-+ + + + + +-+ + +
| | |     | | |   |       | | | |
+ + + +-+-+ + + +-+ + +-+-+ + + +
| | |     |   |   | |   | | | | |
+ + + +-+-+-+ + + + +-+-+ + + + +
| | |       | |   | | |   | | | |
+ + +-+-+ + + +-+-+ + + + + +-+ +
| | |     |     |   |   |   |   |
+ + + +-+-+ +-+-+ +-+-+ +-+ + + +
| | |       | |       |   |   | |
+ + + +-+ +-+ +-+-+-+ +-+ + + + +
| | |   |   |           |   | | |
+ + + + + + + +-+-+-+-+-+-+ + + +
| | | | | |       |         | | |
+ + + + +-+ + +-+-+ +-+-+ +-+ + +
| | | |   | |       |       | | |
+ + + +-+-+-+-+-+-+-+-+-+-+ + + +
| | |             |             |
+ + +-+-+-+-+-+-+ +-+-+-+-+-+-+ +
| |           |                 |
+-+-+-+-+-+-+-+-+-+-+-+-+-+-+-+-+
