+-+-+-+-+-+-+-+-+-+-+-+-+-+-+-+-+
|                               |
+ +-+-+-+-+-+-+-+-+-+-+-+-+ +-+ +
|               |           | | |
+-+-+-+ +-+-+-+-+ +-+-+-+ + + + +
| |             |         | |   |
+ +-+-+-+-+-+ +-+ +-+-+-+ +-+ + +
| |           | |             | |
+ +-+-+-+ +-+-+ +-+-+-+ + +-+-+ +
| |           |   |   | |     | |
+ +-+ +-+-+-+-+ + + + + + +-+ + +
|     |         |   |   | | | | |
+ +-+-+ +-+-+-+-+-+-+-+-+-+ + + +
|     |                     | | |
+ +-+-+-+-+-+-+-+-+-+ +-+-+ + + +
|             |   |     |   | | |
+ +-+-+-+-+-+-+ + + +-+-+ +-+ + +
|             |   | |       | | |
+-+-+-+-+ +-+ + +-+ +-+-+-+ + + +
|         | | |     |   |   | | |
+ +-+-+ +-+ + +-+-+-+ + + +-+ + +
|       |   | | | | | | |   | | |
+-+-+ +-+ +-+ + + + + + +-+ + + +
|     |   |   | | |   | | |   | |
+-+ +-+ +-+ + + + + + + + +-+-+ +
|   |   |   | | | | | |   |     |
+ +-+ +-+ + + + + + + + + + + + +
|     |   | | | | | | | | | | | |
+-+ +-+ + + + + + + + + + + + + +
|   |   | | | | | | | | | | | | |
+ + + + + + + + + + +-+-+ + + + +
| |   | |   |           |       |
+-+-+-+-+-+-+-+-+-+-+-+-+-+-+-+-+
