+-+-+-+-+-+-+-+-+-+-+-+-+-+-+-+-+
|                           |   |
+ +-+-+-+-+ +-+ +-+-+-+ +-+-+ + +
|     |     | | |     |   |   | |
+ +-+ + + + + + + +-+ + + + +-+ +
| |   | | |   | |   | | |   |   |
+ + +-+ + +-+-+ +-+ + + +-+-+ + +
|   |   | |   |     | |       | |
+ + + + +-+ + +-+-+-+ +-+-+-+-+ +
| | | | |   |                   |
+-+ + +-+ +-+ +-+-+-+-+ +-+-+-+ +
|     |     | |         |       |
+ +-+-+ +-+ + + +-+-+-+ + +-+-+ +
|   |   | | | |       | |     | |
+ +-+ +-+ + + +-+-+ +-+ + +-+ + +
| |   |   | | |   | |   |   | | |
+ + + + + + + + + + + +-+-+ + + +
| | |   |   |     |   |   | | | |
+ + +-+ + +-+-+-+-+ +-+ + + + + +
| |   | |     |   | |   |   | | |
+ +-+ + +-+ +-+ + + + +-+-+-+ + +
|   | |   | |   | | | |       | |
+-+ + +-+ + + +-+ + + + +-+-+-+ +
|   |   | | | |   | | | |       |
+ +-+-+ + + + + +-+ + + + +-+-+ +
| |   | | | | | |   | | | |   | |
+ + + + + +-+ + + +-+ + + + +-+ +
|   | | |     | |     | | |     |
+ + + + +-+-+-+ + +-+-+ + +-+-+-+
| | | |                 |       |
+ + + +-+-+-+-+-+-+-+-+ + +-+-+ +
| |                       |     |
+-+-+-+-+-+-+-+-+-+-+-+-+-+-+-+-+
