+-+-+-+-+-+-+-+-+-+-+-+-+-+-+-+-+
|                           |   |
+ +-+-+-+ +-+-+ +-+-+-+ +-+-+ + +
|     | |   | | |     |   |   | |
+ +-+ + + + + + + +-+ + + + +-+ +
| |   |   |   | |   | | |   |   |
+ + +-+ + +-+-+ +-+ + + +-+-+ + +
|   |   | |   |     | |       | |
+ + + + +-+ + +-+-+-+ +-+-+-+-+ +
| |   | |   |       |           |
+-+ + +-+ +-+ +-+-+ +-+-+-+-+-+ +
|   | |     | |         |       |
+ + +-+ +-+ + + +-+-+-+ + +-+-+ +
| | |   | | | |       | |     | |
+ +-+ +-+ + + +-+-+ +-+ + +-+ + +
| |   |   | | |   | |   |   | | |
+ + + + + + + + + + + +-+-+ + + +
| | |   |   |     |   |   | | | |
+ + +-+ + +-+-+-+-+ +-+ + + + + +
| |   | |     |   | |   |   | | |
+ +-+ + +-+ +-+ + + + +-+-+-+ + +
|   | |   | |   | | | |       | |
+-+ + +-+ + + +-+ + + + +-+-+-+ +
|   |   | | | |   | | | |       |
+ +-+-+ + + + + +-+ + + + +-+-+ +
| |   | | | | |     | | | |   | |
+ + + + + +-+ + +-+-+ + + + +-+ +
|   | | |     | |     | | |     |
+ + + + +-+-+-+ + +-+-+ + +-+-+-+
| | | |         |       |       |
+ + + +-+-+ +-+-+-+-+-+ +-+-+-+ +
| |   |                         |
+-+-+-+-+-+-+-+-+-+-+-+-+-+-+-+-+
