+-+-+-+-+-+-+-+-+-+-+-+-+-+-+-+-+
|       |                       |
+ +-+-+-+ +-+-+ +-+-+ +-+-+ + + +
| | |   | | |     |     |   | | |
+ + + + + + + + +-+-+ +-+ +-+ + +
|   | | |     |             | | |
+ + + + + + + + +-+-+ +-+-+-+ + +
| | | |   | | | | |   | |   | | |
+ + + + + + +-+-+ + + + +-+ + + +
| | | | | |         |       | | |
+ + + + +-+-+-+-+-+-+ +-+-+ + + +
| | | | | |       | | | | | | | |
+ + + + + + +-+-+ + + + + + + + +
| | | | | |         | | |   | | |
+ + + + + + +-+-+-+ + + + + + + +
| | | | | |   |     | | | | | | |
+ + + + + +-+ + + +-+-+ + + + +-+
| | | | | |   |   |   | | | |   |
+ + + + + + +-+-+-+ + + + + +-+ +
| | | | | |   |     | | | | |   |
+ + + + + +-+ + +-+-+-+ + + + + +
| | | | | |   |         | |   | |
+ + + + + + +-+-+-+-+-+ + + + + +
| |     | | | |         | | | | |
+ + + + + + + + +-+-+-+-+ + + + +
| | | | | |               | | | |
+ +-+-+ + +-+-+-+-+-+-+-+-+-+ + +
|   | |                       | |
+ + + +-+-+-+-+-+-+-+-+-+-+-+ + +
| |         |   |   |         | |
+ +-+-+-+-+ + + + + +-+-+-+-+-+ +
| |           |   |             |
+-+-+-+-+-+-+-+-+-+-+-+-+-+-+-+-+
