+-+-+-+-+-+-+-+-+-+-+-+-+-+-+-+-+
|                       |       |
+ + +-+-+-+-+-+-+-+-+ + + +-+-+ +
| | |   |   |   |   | | | |   | |
+ + + + + + + + + + + + + +-+ + +
| |   |   |   |   | | | |     | |
+ +-+-+-+-+-+-+-+-+ + + +-+-+-+ +
| |                 | |         |
+ + +-+-+-+-+-+-+-+-+-+-+ +-+-+-+
| | |             |             |
+ + + +-+-+-+-+-+ +-+-+ +-+-+-+ +
| | | |           |           | |
+ + + + +-+-+-+-+-+-+ +-+-+-+ + +
| | | |         |       |     | |
+ + + +-+-+-+ +-+-+ +-+-+ +-+-+ +
| | | |     | |   |   |         |
+ + + + +-+ + + + +-+ +-+-+-+-+ +
| | |   |   |     |   |       | |
+ + +-+-+ +-+-+-+-+ +-+ +-+-+ + +
| |                 |       | | |
+ +-+-+-+-+-+-+ +-+-+-+-+-+ + + +
|       |     |             | | |
+-+ +-+ + +-+ +-+-+-+-+-+-+-+ + +
|     | |     |             | | |
+ +-+ + +-+-+ +-+-+-+-+-+-+ + + +
|     |       |             | | |
+ + +-+-+-+-+ + +-+-+-+-+-+ + + +
| | |         |           | | | |
+ + + +-+-+-+-+-+-+-+-+-+ + + + +
| | |                     |   | |
+ + +-+-+-+-+-+-+-+-+-+-+-+-+-+ +
| |                             |
+-+-+-+-+-+-+-+-+-+-+-+-+-+-+-+-+
