+-+-+-+-+-+-+-+-+-+-+-+-+-+-+-+-+
|                             | |
+ +-+-+ +-+ + +-+ +-+-+ +-+-+ +-+
| | |   |   | |     |           |
+ +-+ +-+ +-+ +-+ +-+ +-+ +-+-+ +
| |   |   |         |           |
+ + +-+ +-+-+-+-+ +-+-+ +-+ +-+ +
|   |   |     |     |         | |
+ +-+ +-+ +-+ +-+ +-+ +-+-+-+ + +
| |   |   |   |     |           |
+ + +-+ +-+ + +-+ +-+ +-+ +-+-+ +
|   |   | | | |       | | |     |
+ +-+ +-+-+ + +-+ +-+ + + + +-+ +
| |   |     |   |       | |   | |
+ + +-+ +-+-+ +-+-+ + +-+ +-+ + +
|   | | |   | |   | | |     | | |
+ +-+-+ + + + + + + +-+ + + + + +
|       | | |     | |   | | | | |
+-+-+-+-+ + +-+-+-+-+ +-+ + + + +
|                 |   | | | | | |
+-+-+-+ +-+-+-+ +-+ +-+-+ + + + +
|               |   |     | | | |
+-+-+ +-+-+-+ +-+ +-+ +-+-+ + + +
|             |   | | |     | | |
+ +-+-+-+ +-+-+ +-+-+ + +-+ + + +
| |     |             | | | | | |
+ + +-+ + +-+ + +-+-+-+ +-+ + + +
| |       | | |             | | |
+ + +-+-+ +-+ +-+-+-+-+-+-+-+ + +
|   |                         | |
+ + +-+-+-+-+-+-+-+-+-+-+-+-+-+ +
| |                             |
+-+-+-+-+-+-+-+-+-+-+-+-+-+-+-+-+
