+-+-+-+-+-+-+-+-+-+-+-+-+-+-+-+-+
|   |           |               |
+ +-+ +-+ + +-+ + +-+-+-+-+-+-+ +
| |   |   |                   | |
+ + +-+ + + +-+-+-+-+-+-+-+-+ + +
|   |   | |                 |   |
+ +-+ +-+ +-+ +-+-+-+-+-+-+ + + +
|     |   |               |   | |
+ + +-+ + + +-+-+-+-+-+-+ + +-+ +
| | |   |   |           |   | | |
+ + + +-+ +-+ +-+-+-+-+ + + + + +
| | | |   |   |       |   | | | |
+ + + + + + +-+ +-+-+ + + + + + +
| | | | |           |   | | | | |
+ + + + + +-+ +-+-+ + + + + + + +
|   | | | |   |   | | | | | |   |
+-+ + + + + +-+ + + + + + + + +-+
|   | | | | |     |   | | | |   |
+ + + + + + + +-+-+ +-+ + + + + +
| | | | | | |       |   | | | | |
+ + + + + + +-+-+ +-+ +-+ + + + +
| | | | | |       |         | | |
+ + + + + +-+ +-+-+ +-+ +-+-+ + +
| | | | |           |   |     | |
+ + + + +-+ +-+-+-+-+ +-+ +-+ + +
| | | |               |   |   | |
+ + + +-+-+-+-+-+-+ +-+ +-+ +-+ +
| |                     |   |   |
+ + +-+-+-+-+-+-+-+-+-+-+ +-+-+ +
| |                       |     |
+ +-+-+-+-+-+-+ + +-+-+-+-+ + +-+
| |             |           |   |
+-+-+-+-+-+-+-+-+-+-+-+-+-+-+-+-+
