+-+-+-+-+-+-+-+-+-+-+-+-+-+-+-+-+
|   |           |               |
+ +-+ +-+ + +-+ + +-+-+-+-+-+-+ +
| |   |   |             |     | |
+ + +-+ + + +-+-+-+-+-+ + +-+ + +
|   |   | |             |   |   |
+ +-+ +-+ +-+ +-+-+-+-+-+-+ + + +
|     |   |   |           |   | |
+ + +-+ + + +-+-+-+-+-+-+ + +-+ +
| | |   |   |           |   | | |
+ +-+ +-+ +-+ +-+-+-+-+ + + + + +
| | | |   |   |       |   | | | |
+ + + + + +-+-+ +-+-+ + + + + + +
| | | | |     |     |   | | | | |
+ + + + + +-+ +-+-+ + +-+ + + + +
|   | | | |   |   | | | | | |   |
+-+ + + + + +-+ + + + + + + + +-+
|   | | | | |     |   | | | |   |
+ + + + + + + +-+-+ +-+ + + + + +
| | | | | | |       |   | | | | |
+ + + + + + +-+-+-+-+ +-+ + + + +
| | | | | |       |     |   | | |
+ + + + + +-+ +-+-+ +-+ +-+-+ + +
| | | | |           |   |     | |
+ + + + +-+ +-+-+-+-+ +-+ +-+ + +
| | | |               |   |   | |
+ + + +-+-+-+-+-+-+ +-+ +-+ +-+ +
| |                     |   |   |
+ + +-+-+-+-+-+-+-+-+-+-+ +-+-+ +
| |                       |     |
+ +-+-+-+-+-+-+ + +-+-+-+-+ + +-+
| |             |           |   |
+-+-+-+-+-+-+-+-+-+-+-+-+-+-+-+-+
