+-+-+-+-+-+-+-+-+-+-+-+-+-+-+-+-+
|       | |                     |
+ +-+-+-+ +-+-+-+-+-+-+ +-+ +-+ +
| |                   | | | | | |
+ +-+-+-+ + + +-+-+-+ + + + + + +
|         | |         | | | | | |
+ +-+-+ +-+ + +-+-+-+ + + + + + +
| |       | | |       | | | | | |
+ + +-+-+-+ + + + +-+ +-+ + + + +
| | |       | | | |     | | | | |
+ + + +-+-+-+-+-+ +-+ + + + + + +
| | | |   |         | | | | | | |
+ + + + + + +-+-+-+-+ + + + + +-+
| | | | | | |       | | |       |
+ + + + + + + +-+-+ + + +-+ +-+-+
| | |   | | | |     | |   |     |
+ + +-+ + + + + + + + +-+ + +-+-+
| |     | | | |   | | | | | |   |
+ +-+-+-+ +-+-+-+-+ + + + + + + +
| |     |   |       | | | |   | |
+ +-+-+ + + + +-+-+ +-+ + + +-+ +
|       | | | |   |   | | | |   |
+ +-+-+ + + + + + +-+ + + + +-+-+
| |       | | | |     |       | |
+ +-+ + + + + + +-+-+-+-+ + + + +
| |   | | | |           | | |   |
+ + +-+ +-+ + +-+-+-+ +-+ + + + +
| | |   |   | |           | | | |
+ + + +-+ + +-+ +-+-+ +-+-+ + + +
|   | |   |                 | | |
+ +-+ + + + +-+ +-+-+-+-+-+-+ +-+
| |     | |   |                 |
+-+-+-+-+-+-+-+-+-+-+-+-+-+-+-+-+
