+-+-+-+-+-+-+-+-+-+-+-+-+-+-+-+-+
|                               |
+ +-+-+-+-+-+-+-+-+-+-+-+-+-+-+ +
| |                           | |
+ + +-+-+-+-+-+-+-+-+-+-+-+-+ + +
| | |                       | | |
+ + + +-+-+-+-+ +-+ +-+-+-+ + + +
| | | | |     |   |   |   | | | |
+ + + + + +-+ + +-+ +-+ + + + + +
| | |   | |   | |   |   | | | | |
+ + +-+ + + +-+ + +-+ +-+ + + + +
| | | | | |     | |   |   | | | |
+ + + + + +-+-+ + + +-+ +-+ + + +
| | |   | |   | |   |   | | | | |
+ + + +-+ + + +-+-+-+ +-+ + + + +
| | | | | | | |   |   |   | | | |
+ + + + + + + + + + +-+ + + + + +
| | |   | | | |   |     | | | | |
+ + + +-+ + + +-+ + +-+ + + + + +
|         | |     | |     | | | |
+ +-+ +-+ + +-+-+ +-+ +-+-+ + + +
| |       |     | |   |   | | | |
+ + +-+ +-+-+-+ + + +-+ + + + + +
|             | | |     | | | | |
+ +-+ +-+ +-+ + + +-+-+-+ + + + +
|             | |         | | | |
+ +-+ +-+ +-+ + +-+-+-+-+-+ + + +
|             | |           | | |
+ + +-+ +-+ + + +-+-+-+-+-+-+ + +
| |         | |               | |
+ +-+ +-+ +-+ +-+-+-+-+-+-+-+-+ +
| |                             |
+-+-+-+-+-+-+-+-+-+-+-+-+-+-+-+-+
