+-+-+-+-+-+-+-+-+-+-+-+-+-+-+-+-+
|       |                       |
+ + + + + +-+-+-+-+-+-+-+-+-+ + +
| | | | | |       |           | |
+ + + + + + +-+-+ +-+ +-+-+-+-+-+
| | | | | |   |   |             |
+ + + + + +-+ + +-+ +-+ +-+ +-+ +
| |   | |   | | |             | |
+ + + + + +-+ + +-+ +-+-+-+-+ + +
| | |   | |   |   |       |     |
+ + + + + + + +-+ +-+-+-+ +-+-+ +
| | | | | | | |   |   | | |     |
+ + + + + + +-+ +-+ + +-+ + +-+-+
| | | | | |   |     |     | |   |
+ + + + + + + +-+-+-+-+-+-+ + + +
| |     | | | |               | |
+ + + + + +-+ + + +-+-+-+-+-+-+ +
| | | | | |   |   |           | |
+ + + + + + +-+-+-+ +-+ +-+-+ + +
| |   | | |       |   |   |   | |
+ + + + + + + +-+ +-+ +-+ + + + +
| | |   | | | |     |   |   | | |
+ + + + + + +-+ +-+ +-+ +-+ + + +
| | | | | | |   | |   |   |   | |
+ + +-+ + + + +-+ +-+ +-+ +-+ + +
| |       |   |     |   |   |   |
+ +-+ +-+-+ +-+-+ +-+-+ +-+ +-+ +
| |   |     |         |   |   | |
+ +-+-+-+ + +-+ +-+ +-+-+ +-+ +-+
|   |     |             |   |   |
+ + +-+ +-+ +-+-+-+-+ +-+-+ +-+ +
| |                       |     |
+-+-+-+-+-+-+-+-+-+-+-+-+-+-+-+-+
