+-+-+-+-+-+-+-+-+-+-+-+-+-+-+-+-+
|                           |   |
+ + +-+-+-+-+ + +-+-+-+-+-+ + + +
| | |       | | |         | | | |
+ + + +-+-+-+ + +-+-+-+-+ + + + +
| | | |       |               | |
+ +-+ +-+-+-+ +-+-+-+-+-+-+ +-+ +
|   |       |                 | |
+-+ + +-+ +-+ + +-+-+ +-+-+ + + +
|   |   |     |     | | |   | | |
+ +-+ + + +-+-+-+-+ + + + +-+ + +
| | | |   |       |   |       | |
+ + +-+ +-+ +-+-+ +-+ + + +-+-+ +
| |     |   |   |   | | |       |
+ +-+-+ + +-+ + +-+ + + + +-+ +-+
|   |   | |   |   | | | | |     |
+ + + +-+ + +-+ + + + + + + +-+ +
| | | |   |   |   | | | |     | |
+ + + + +-+-+ +-+-+ + + + + + + +
| | | |     |       | |   | | | |
+ + + +-+-+ +-+ +-+-+ +-+-+ + + +
| | |   |       |         | | | |
+ + + + +-+ +-+-+ +-+-+ +-+ + + +
|   | |   | |     |   |     |   |
+ + + +-+ + + +-+-+ + + +-+ + +-+
| | |         |     | |     |   |
+ + +-+-+-+-+-+ +-+-+ + +-+-+ + +
| |           | |           | | |
+ + +-+-+-+-+ + + +-+-+ +-+-+ + +
| |             | |   |       | |
+ +-+-+ + +-+-+-+ +-+ +-+-+ + + +
| |     |                   | | |
+-+-+-+-+-+-+-+-+-+-+-+-+-+-+-+-+
