+-+-+-+-+-+-+-+-+-+-+-+-+-+-+-+-+
|                           |   |
+ + +-+-+-+-+ + +-+-+ +-+-+ + + +
| | |       | | |         | | | |
+ + + +-+-+-+ + +-+ +-+-+ + + + +
| | | |       |               | |
+ +-+ +-+-+-+ +-+-+-+-+-+-+ +-+ +
|   |                         | |
+-+ + +-+ +-+ + +-+-+ +-+-+ + + +
|   |   | |   |     | | | | | | |
+ +-+ + + +-+-+-+-+ + + + +-+ + +
| | | |           |   |       | |
+ + +-+ +-+ +-+-+ +-+ + + +-+-+ +
| |     |   |   |   | | |       |
+ +-+-+ + +-+ + +-+ + + + +-+ +-+
|   |   | |   |   | | |   |     |
+ + + +-+-+ +-+ + + + + + + +-+ +
| | | |   |   |   | | | |     | |
+ + + + +-+-+ +-+-+ + + + + + + +
| | | |     |       | |   | | | |
+ + + +-+-+ +-+ +-+-+ +-+-+ + + +
| | |   |       |         | | | |
+ + + + +-+ +-+-+ +-+-+-+-+ + + +
|   | |   | |     |   |         |
+ + + +-+ + +-+-+-+ + + +-+ + +-+
| | |         |     | |     |   |
+ + +-+-+-+-+-+ +-+-+ + +-+-+ + +
| |           | |           | | |
+ + +-+-+-+-+ + + +-+-+ +-+-+ + +
| |             | |   |       | |
+ +-+-+ + +-+-+-+ +-+ +-+-+ + + +
| |     |                   | | |
+-+-+-+-+-+-+-+-+-+-+-+-+-+-+-+-+
