+-+-+-+-+-+-+-+-+-+-+-+-+-+-+-+-+
|                         |     |
+-+-+-+ +-+-+ +-+ +-+-+ +-+-+ + +
|     | | |       |   |       | |
+ + + + + + +-+-+-+ +-+-+-+-+ + +
| | | | | |   | |           |   |
+ + + + + +-+ + + +-+-+-+-+ +-+ +
|     | | |   |   |       |     |
+ +-+ + + + +-+ +-+-+ +-+ +-+-+ +
|   | | | |   | |       |       |
+-+ + + + +-+ + + +-+-+-+-+-+-+-+
|     | | |   | |         |   | |
+ +-+ + + + +-+ +-+-+ +-+ + + + +
|   | | | |   |     |       |   |
+-+ + + + +-+ +-+-+ + + +-+ + + +
|   | | | |   |   | | |       | |
+ +-+ + + + +-+ + + + + + +-+ + +
|   | | |   | |   | |   |       |
+-+ + + + +-+ +-+ + +-+ + + +-+ +
|   | |   |   |   |   |   |     |
+ +-+ + +-+ + +-+ +-+ +-+ + + +-+
|   |   |   |   |   |   |   |   |
+-+ +-+-+ +-+-+ +-+ +-+ +-+ + + +
|     |   |   |   |   |   |   | |
+ +-+-+ + + + +-+ +-+ +-+ +-+ + +
|   |   | | |   |   |   |   | | |
+-+ + +-+-+ +-+ +-+ +-+ +-+ +-+ +
|       |         |   |   |   | |
+ +-+-+ + +-+ +-+ +-+ +-+ +-+ + +
| |     |             |       | |
+ + +-+-+-+-+-+-+-+-+-+-+-+-+-+ +
| |                             |
+-+-+-+-+-+-+-+-+-+-+-+-+-+-+-+-+
