+-+-+-+-+-+-+-+-+-+-+-+-+-+-+-+-+
|       |                   |   |
+ +-+ +-+ +-+ +-+-+-+-+-+-+ + + +
| |       |   |             | | |
+ + +-+ +-+ +-+ +-+-+-+-+-+-+ + +
|   |   |   |             |   | |
+ + + +-+ +-+-+-+-+-+-+-+ + + + +
| |   |   |               | | | |
+ + +-+ +-+ +-+-+-+-+-+-+-+ + + +
|   |   |                 | | | |
+ +-+ +-+-+-+-+-+-+-+-+ +-+ + + +
| |   | | | | |         |   | | |
+ + +-+ + + + + +-+-+-+-+ +-+ + +
|   | |           |     | |   | |
+ +-+ + + + + +-+-+ +-+ + + +-+ +
|     | | | | |   |   | | |   | |
+ + + + + +-+-+ + +-+ + + +-+ + +
| | | |           |   | | |   | |
+ + + + +-+-+-+-+-+ +-+ + + +-+ +
|     |               | | |   | |
+-+ + + + +-+-+-+-+-+-+ + +-+ + +
| | | | | |   |   |   |   |   | |
+ + + +-+-+ + + + + + +-+-+ +-+ +
|   |       |   |   | |         |
+ + +-+ +-+ +-+-+-+ + + +-+ +-+ +
| |         |       |         | |
+ +-+ + +-+-+ +-+-+ +-+-+ +-+ + +
|     |   |     |     |       | |
+ +-+ +-+ + +-+-+-+-+ + +-+-+-+ +
| | |   |   |       |   |       |
+ + +-+ +-+-+ +-+-+ +-+-+ +-+-+ +
| |             |           |   |
+-+-+-+-+-+-+-+-+-+-+-+-+-+-+-+-+
