+-+-+-+-+-+-+-+-+-+-+-+-+-+-+-+-+
|   | | |   |   |   |       |   |
+ +-+ + + + + + + + +-+-+-+ +-+ +
|     |   |   |   |     |   | | |
+ +-+ + +-+-+-+-+-+-+ + + + + + +
|   |   |     |   |   | | |     |
+ +-+-+ +-+ +-+ + + +-+ + + + +-+
|   |         | |     |   | |   |
+ +-+-+-+ +-+ + + +-+-+ +-+ + +-+
|           |   |   |   |   |   |
+-+ +-+ +-+ +-+-+ +-+ +-+-+ + + +
|   |   |   |     | |   |   | | |
+-+ +-+-+-+-+ +-+-+ +-+ + +-+ + +
| |   |       |   |             |
+ + +-+ +-+-+-+-+-+ +-+-+ + +-+-+
|   | |   | | |         | |     |
+ + + + + +-+ + + + +-+-+ + +-+ +
| | |   | | | |   | |   | | |   |
+ +-+-+ + + + +-+-+ + + + +-+-+ +
|         | |   |   | |       | |
+ +-+ + +-+ + + +-+-+-+ +-+-+ + +
| |   |   | |     |   | |     | |
+ + +-+-+ + +-+-+-+-+-+ +-+-+-+ +
|     |   | | |       | | |     |
+ +-+ + +-+ + + +-+-+ + + +-+ +-+
|   | |   | | |   |   | | |     |
+ +-+ +-+ + + +-+ + +-+ + + +-+ +
|     |   | | |   | |   |     | |
+ +-+ + +-+ + + + + +-+-+ +-+ + +
|   |     | |   | |         |   |
+ + +-+-+-+-+ +-+ + +-+ +-+-+ +-+
| |           |     |   |       |
+-+-+-+-+-+-+-+-+-+-+-+-+-+-+-+-+
