+-+-+-+-+-+-+-+-+-+-+-+-+-+-+-+-+
|                 |             |
+ +-+ +-+-+-+ + +-+-+ +-+-+ +-+ +
| |   |       |       |       | |
+ + +-+ +-+-+-+-+-+-+-+ +-+-+ + +
|   |   |       |           |   |
+ +-+ +-+ +-+-+ +-+-+ +-+-+ + + +
| |   | | | |     |       |   | |
+ + +-+-+ +-+ +-+-+ +-+-+ + + + +
| | |     |   |         |   |   |
+ + + +-+-+ +-+ +-+-+ + + +-+-+ +
| | | | |   |         |   | |   |
+ + + +-+ +-+ +-+-+-+ + +-+ + +-+
|     |   | |       |     |   | |
+ +-+-+ +-+ + +-+-+ + + +-+ +-+ +
| |     |   | |   |   | |   | | |
+ + +-+-+ + + + + + + + + +-+ + +
| | | | | | | |   | |   | |     |
+-+ + + + + + + +-+ + +-+ + + + +
| | |   | | |         |   | | | |
+ + + + + + +-+-+-+-+-+ +-+ + + +
|   | | | |         |   | | | | |
+ +-+ + + +-+-+-+ +-+ +-+-+ + + +
| |   | |     |   |   |     | | |
+ + + + +-+-+ + +-+ +-+ +-+-+ + +
| | | |       |     | | | |   | |
+ + + +-+-+-+-+-+ +-+-+ +-+ +-+ +
| | |           |       |   |   |
+ +-+-+-+ +-+-+-+-+-+-+-+ +-+ + +
|         |               |   | |
+ +-+ +-+-+ +-+-+-+ +-+ +-+ +-+ +
| |                             |
+-+-+-+-+-+-+-+-+-+-+-+-+-+-+-+-+
