+-+-+-+-+-+-+-+-+-+-+-+-+-+-+-+-+
|             |   |     |   |   |
+ +-+-+-+ +-+-+-+ +-+ + + + + + +
| |       |       |   |   | | | |
+ +-+ +-+-+ + + +-+ +-+-+ + + + +
| |   |     | | | |   | | | | | |
+ + + + +-+-+ + +-+ +-+ + + + + +
| | | |   | | |     |   | | | | |
+ +-+ + +-+ + +-+-+-+ + + + + + +
|   | |   | |     |   |   | | | |
+-+ + +-+ + +-+ +-+ +-+ + + + + +
| | |   | |     |     | | |   | |
+-+ +-+ + +-+-+ + +-+ + + +-+ + +
|     | |   |     |     | |   | |
+ +-+ + +-+ + + +-+ +-+ +-+ +-+ +
| | | |     | |   |   | |   |   |
+-+ + +-+-+-+ + + +-+ +-+ +-+ + +
| | |     |   |   | |   | |   | |
+ + +-+-+ +-+ +-+-+ +-+ + + +-+-+
| | |   | | |           | | |   |
+ + +-+ + + +-+ +-+-+-+ + + + + +
| |       | | |         | | | | |
+ + +-+-+-+ + +-+ +-+-+ + + + + +
|         |   | |       | | | | |
+-+-+-+ + + + + +-+ +-+ + + + + +
|       |   | |   |     | | | | |
+ +-+-+-+-+-+ + + +-+ +-+ + + + +
|           |   |   |     |   | |
+-+-+-+-+-+ +-+-+ +-+-+-+-+ +-+ +
|               |       | | |   |
+ + +-+-+-+-+-+ + + +-+-+ +-+ + +
| |               |           | |
+-+-+-+-+-+-+-+-+-+-+-+-+-+-+-+-+
