+-+-+-+-+-+-+-+-+-+-+-+-+-+-+-+-+
|     |                         |
+ +-+ + +-+-+-+-+-+-+-+-+-+-+-+ +
| | | |       |               | |
+ + + +-+ + +-+ + +-+-+-+-+-+ + +
| |   | | | |   |   |       | | |
+ + +-+ +-+ + + + +-+ +-+ +-+ + +
| | |   |   | |     |   |   | | |
+ + + +-+ +-+ + + + +-+ +-+ + + +
| | | |   |   | | |   |   | |   |
+ + + + +-+ +-+ + +-+ +-+ + +-+-+
| | |   |   |   |   |     | |   |
+ + + + + + +-+ + +-+ + + + + + +
| | | | | | |       | | | | | | |
+ + + +-+ + + +-+-+ + +-+-+ + + +
| | | | | | |       | |   | | | |
+ + + + + + +-+ + +-+ + + + + + +
| | | | | |   |   |   | | | | | |
+ + + + + +-+ +-+-+ +-+ + + + + +
| |   | |   |   |   |   | | | | |
+ +-+-+ +-+ +-+ + +-+ +-+ + + + +
| |       |   |   |   |   |   | |
+ + + +-+ +-+ +-+-+ +-+ +-+-+-+ +
| | | | |   |   |   |   |       |
+ + +-+ +-+ +-+ + +-+ +-+ +-+-+-+
| | | |   |   |   |   |         |
+ + + +-+ +-+ +-+-+ +-+-+-+-+-+ +
| |   |     |       |           |
+ +-+ +-+-+ +-+-+-+-+-+-+ +-+-+-+
|   |                 |         |
+ + +-+-+-+-+-+-+ +-+-+-+-+-+-+ +
| |                             |
+-+-+-+-+-+-+-+-+-+-+-+-+-+-+-+-+
