+-+-+-+-+-+-+-+-+-+-+-+-+-+-+-+-+
|   |   |     |   |       |     |
+ + + + + +-+ + + + + +-+ + + + +
| | | | |   |   | | | |   | | | |
+ + + + +-+ +-+-+ + + + +-+ +-+ +
| | | |   |     |   | | | | |   |
+ + + +-+ +-+-+ +-+-+ + +-+ + +-+
| | | | |     |     | | | | |   |
+ + + +-+-+-+ +-+-+ + + +-+ +-+ +
| |   |   | |       | |     |   |
+ +-+ +-+ +-+-+-+-+-+ +-+-+-+-+ +
| | |   |             |     |   |
+ + + +-+ +-+-+-+-+ + + +-+ + +-+
|   | |           | | | |   |   |
+ + +-+-+-+-+ +-+-+ + + + +-+-+ +
| | |   |     |     |   |   |   |
+ + + + + + +-+ + +-+ +-+-+ + +-+
| | | | | |   |   | | | |   |   |
+-+ + + +-+-+ +-+-+-+-+ + +-+-+ +
| | | | |   | |   |     |   |   |
+-+ + + + + + + + + +-+ +-+ + +-+
|   | | | | | | | | | |     |   |
+ + + + + + + + + + + +-+ +-+ + +
| | | | | | |   |     |   |   | |
+ + + + + + +-+-+-+ +-+ +-+ +-+ +
| | | | | |         |   |   |   |
+ + + + + +-+-+-+-+-+ +-+ +-+ + +
| | | |               |   |   | |
+ + + +-+-+-+-+-+-+ +-+ +-+ + + +
| | |             |     |   | | |
+ + +-+-+-+-+ +-+-+-+-+-+ +-+ + +
| |                             |
+-+-+-+-+-+-+-+-+-+-+-+-+-+-+-+-+
