+-+-+-+-+-+-+-+-+-+-+-+-+-+-+-+-+
|                               |
+ + + + + + + + + + + + + + + + +
|                               |
+ + + + + + + + + + + + + + + + +
|                               |
+ + + + + + + + + + + + + + + + +
|                               |
+ + + + + + + + + + + + + + + + +
|                               |
+ + + + + + + + + + + + + + + + +
|                               |
+ + + + + + + + + + + + + + + + +
|                               |
+ + + + + + + +-+-+ + + + + + + +
|             |   |             |
+ + + + + + + + + + + + + + + + +
|             |   |             |
+ + + + + + + +-+-+ + + + + + + +
|                               |
+ + + + + + + + + + + + + + + + +
|                               |
+ + + + + + + + + + + + + + + + +
|                               |
+ + + + + + + + + + + + + + + + +
|                               |
+ + + + + + + + + + + + + + + + +
|                               |
+ + + + + + + + + + + + + + + + +
| |                             |
+ + + + + + + + + + + + + + + + +
| |                             |
+-+-+-+-+-+-+-+-+-+-+-+-+-+-+-+-+

