+-+-+-+-+-+-+-+-+-+-+-+-+-+-+-+-+
| |           |       |     |   |
+ +-+-+-+-+-+ + + +-+ +-+ + + +-+
|   |       |   |   |     |     |
+ + + + +-+-+ +-+ + +-+ +-+ +-+ +
| | | |       |   | | | |     | |
+ + + + +-+ +-+ +-+ + + + +-+ + +
| |   | |   |   |   | | |       |
+ +-+-+-+ +-+ +-+ +-+ + +-+ + + +
|         |   |   |   | |   | | |
+ +-+-+-+-+ +-+ +-+ + + + +-+ +-+
|       |   |   |   | | |       |
+ +-+-+-+ +-+ +-+ + + + +-+ +-+ +
|     |   |   |   | | | |     | |
+ +-+-+ +-+ +-+-+-+ + + + +-+ + +
|   |   |   | |   | | | |   |   |
+ +-+ +-+ +-+ + + + + + +-+ + + +
| |   |   |   |   |   | |     | |
+ + +-+ +-+ + +-+ + + + + +-+ +-+
|   |   |   |     | | | |       |
+ +-+ +-+ +-+ + + + + + +-+ +-+ +
| |   |     | | | | | | |     | |
+ + +-+ +-+-+-+-+ + + + + +-+ + +
| | |         | | | | | |       |
+ + +-+-+-+-+ + + + + + +-+ + + +
| |         |   | | | | |   | | |
+ + +-+ +-+ +-+ + + + + + +-+ + +
| | |   | |   | | | |   |     | |
+ + + + + +-+ +-+ +-+-+-+-+ + +-+
| | | | |   |       |   |   |   |
+ + + + + + +-+ + + + + + + + + +
| |   |   |     | |   |   |   | |
+-+-+-+-+-+-+-+-+-+-+-+-+-+-+-+-+

