+-+-+-+-+-+-+-+-+-+-+-+-+-+-+-+-+
|   |         |                 |
+ +-+-+-+-+-+ + +-+-+-+-+-+-+-+ +
|           | | |             | |
+ + +-+-+-+ + + + +-+-+-+-+-+ + +
| | |     | | | | |   |     | | |
+ + + +-+ + + + + + + + +-+ + + +
| | | | | | | | | | | |   | | | |
+ + + +-+ + + + + + + +-+ + + + +
| | |       | | | | | |   | | | |
+ + +-+ +-+-+ + + + + + + + + + +
| | |           |   |   | | | | |
+ +-+-+-+-+-+-+ + +-+-+-+-+ + + +
|             | | |         | | |
+ +-+-+-+-+-+-+-+-+ +-+-+-+-+ + +
|             |   | |         | |
+-+-+-+-+-+-+ + + + + +-+-+-+-+ +
| |           |   | |           |
+ + +-+ +-+-+-+-+ + +-+-+-+-+-+-+
| | | | |     | | | |   |   |   |
+ + + + + +-+ + + + + + + + + + +
| | | |     |   | | | |   |   | |
+ + + + +-+ + + + + + +-+-+-+-+ +
| | | | | | | | | | |   |   | | |
+ + + + +-+ + + + + +-+ + + + + +
| | | |     | | | | | | | | | | |
+ + + +-+-+-+ + + + + + + + + + +
| | |         | | | | |   |   | |
+ +-+-+-+-+-+-+ + + + +-+-+-+ + +
|             | | |           | |
+ +-+-+-+-+-+ + + +-+-+-+-+-+-+ +
| |             |               |
+-+-+-+-+-+-+-+-+-+-+-+-+-+-+-+-+

