+-+-+-+-+-+-+-+-+-+-+-+-+-+-+-+-+
|                               |
+-+ +-+-+-+-+-+-+-+-+-+-+-+-+ +-+
|                 | | | | | | | |
+-+-+-+-+-+-+ + + +-+ +-+ +-+ +-+
|             | | |             |
+-+-+-+-+-+-+ + + + +-+ +-+ +-+ +
|                 | | | | | | | |
+ + +-+-+-+-+-+-+-+ +-+ +-+ +-+ +
| |               |             |
+ + +-+-+-+-+-+-+-+-+ +-+ +-+ +-+
|                 | | | | | | | |
+-+-+-+-+-+-+ + + +-+ +-+ +-+ +-+
|             | | |             |
+-+-+-+-+-+-+ +-+-+ +-+ +-+ +-+ +
|             |   | | | | | | | |
+ + + + +-+-+ + + + +-+ +-+ +-+ +
| |   |   |   |                 |
+ + + +-+ + +-+-+-+-+ +-+ +-+ +-+
|   |   |   |   | | | | | | | | |
+ + +-+ +-+ + + + +-+ +-+ +-+ +-+
| |   |   |   |   |             |
+ + + +-+ + +-+ + + +-+ +-+ +-+ +
|   |       |   | | | | | | | | |
+ + + + + +-+ + + + +-+ +-+ +-+ +
| | | | |     | | |             |
+ + + + + + + + + +-+ +-+ +-+ +-+
|   | | | | | | | | | | | | | | |
+ + + + + + + + + +-+ +-+ +-+ +-+
| | | | | | | | | |             |
+ + + + + + + + + +-+-+-+-+ +-+ +
| |       | |               | | |
+-+-+-+-+-+-+-+-+-+-+-+-+-+-+-+-+

