+-+-+-+-+-+-+-+-+-+-+-+-+-+-+-+-+
|                         |     |
+ +-+ +-+ +-+ +-+ +-+ +-+ + + + +
|                           | | |
+ +-+ +-+ +-+ +-+ +-+ +-+ + + + +
|                         | | | |
+ +-+ +-+ +-+ +-+ +-+ +-+ + + + +
|                           | | |
+ +-+ +-+ +-+ +-+ +-+ +-+ + + + +
|                         | | | |
+ +-+ +-+ +-+ +-+ +-+ +-+ + + + +
|                           | | |
+ +-+ +-+ +-+ +-+-+-+-+-+-+-+ + +
|               |             | |
+ +-+ +-+ +-+ +-+ +-+-+-+-+-+-+ +
|             |   |             |
+ +-+ +-+ +-+ + + + +-+ +-+ +-+ +
|             |   |             |
+ +-+ +-+ +-+ +-+-+-+ +-+ +-+ + +
|                             | |
+ +-+ +-+ +-+ +-+ +-+ +-+ +-+ + +
|                               |
+ +-+ +-+ +-+ +-+ +-+ +-+ +-+ + +
|                             | |
+ +-+ +-+ +-+ +-+ +-+ +-+ +-+ + +
|                               |
+ +-+ +-+ +-+ +-+ +-+ +-+ +-+ + +
|                             | |
+ +-+ +-+ +-+ +-+ +-+ +-+ +-+ + +
|                               |
+ + +-+ +-+ +-+ +-+ +-+ +-+ +-+ +
| |                             |
+-+-+-+-+-+-+-+-+-+-+-+-+-+-+-+-+
