+-+-+-+-+-+-+-+-+-+-+-+-+-+-+-+-+
|     | |     |   |             |
+ +-+ + + +-+ + + + + + + + + + +
| | | | |   |   | | | | | | | | |
+ + + + + +-+ +-+-+ + + + + + + +
| | | |   |       | | | | | | | |
+ + + + +-+-+ +-+ + + + + + + + +
| | | | |   | |   | | | | | | | |
+ + + + + + + + +-+ + + + + + + +
| | | | | | | |   | | | | | | | |
+ + + + + + + + + + + + + + + + +
| | |   | | | | | | | | | | | | |
+ + + +-+-+ + + + + + + + + + + +
| | |     |   | | | | | | | | | |
+ + + +-+ +-+ +-+-+ + + + + + + +
| |     |   | |   | | | | | | | |
+ + + +-+-+ + + + + + + + + + + +
| | | |   | | |   |             |
+ + + + + +-+ +-+ +-+-+-+-+-+ +-+
|   |   |   |   |             | |
+-+ + + + + + + + + +-+-+-+-+-+ +
| | | | | | | |   |             |
+ + + + + + + +-+-+-+ +-+-+-+-+ +
| | | | | | |     |     |     | |
+ + + +-+-+-+-+-+-+-+-+-+ + + + +
| | |   |     |           | |   |
+ + +-+ + +-+ +-+ +-+ +-+ +-+-+ +
|         |       | | | | | | | |
+ +-+ +-+-+-+-+-+ + +-+ + + + + +
|             |   |   | |   | | |
+ +-+-+-+-+ + + + + + + + + + + +
| |         |   |   |   | | |   |
+-+-+-+-+-+-+-+-+-+-+-+-+-+-+-+-+
