+-+-+-+-+-+-+-+-+-+-+-+-+-+-+-+-+
|                               |
+ + + + + + + + + + + + + + + + +
| |                             |
+ + + + + + + + + + + + + + + + +
| |                             |
+ + + + + + + + + + + + + + + + +
| |                             |
+ + + + + + + + + + + + + + + + +
| |                             |
+ + + + + + + + + + + + + + + + +
| |                             |
+ + + + + + + + + + + + + + + + +
| |                             |
+ + + + + + + +-+-+ + + + + + + +
| |           |                 |
+ + + + + + + + + + + + + + + + +
| |           |   |             |
+ + + + + + + +-+-+ + + + + + + +
| |                             |
+ + + + + + + + + + + + + + + + +
| |                             |
+ + + + + + + + + + + + + + + + +
| |                             |
+ + + + + + + + + + + + + + + + +
| |                             |
+ + + + + + + + + + + + + + + + +
| |                             |
+ + + + + + + + + + + + + + + + +
| |                             |
+ + + + + + + + + + + + + + + + +
| |                             |
+-+-+-+-+-+-+-+-+-+-+-+-+-+-+-+-+

