+-+-+-+-+-+-+-+-+-+-+-+-+-+-+-+-+
|     |   |   |   |   |   |   | |
+-+ + + + + + + + + + + + + + + +
|   |   |   |   |   |   |   |   |
+ +-+-+-+-+-+-+-+-+-+-+-+-+-+-+ +
|   |     |   |   |   |   | |   |
+-+ +-+ + + + + + + + + + + + +-+
|   |   |   |   |   |   |   |   |
+ +-+ +-+-+-+-+-+-+-+-+-+-+ +-+ +
|   |   |     |   |   | |   |   |
+-+ +-+ +-+ + + + + + + + +-+ +-+
|   |   |   |   |   |   |   |   |
+ +-+ +-+ +-+-+-+-+-+-+ +-+ +-+ +
|   |   |   |       |   |   |   |
+-+ +-+ +-+ + +-+-+ + +-+ +-+ +-+
|   |   |   | |   | |   |   |   |
+ +-+ +-+ +-+ + + + +-+ +-+ +-+ +
|   |   |   | |   | |   |   |   |
+-+ +-+ +-+ + + +-+ + +-+ +-+ +-+
|   |   |     |     |   |   |   |
+ +-+ +-+-+-+-+-+-+-+-+ +-+ +-+ +
|   |   |   |   |   |   |   |   |
+-+ + + + + + + + + + +-+ +-+ +-+
|   | |   |   |   |     |   |   |
+ +-+-+-+-+-+-+-+-+-+-+-+-+ +-+ +
|   |   |   |   |   |   |   |   |
+-+ + + + + + + + + + + + +-+ +-+
| |   |   |   |   |   |     |   |
+ +-+-+-+-+-+-+-+-+-+-+-+-+-+-+ +
|   |   |   |   |   |   |   |   |
+ + + + + + + + + + + + + + + +-+
| |   |   |   |   |   |   |     |
+-+-+-+-+-+-+-+-+-+-+-+-+-+-+-+-+
